55555311111455555555555553111111145555555
555553P0000455555555555553C00000045555555
5555530000C453111111111147229000045555555
55555790822653000000000011147900014555555
555555304555530000C0000000014300004555555
55555530455553000000000000001100004555555
55555530111111000000008900000000004555555
55555530000000000000001100000000001455555
5555557222229000829000000000000000C455555
55555555553110004530000C00000000082655555
55555531111000004530000000008290045555555
53111110000000001110000000004530045555314
310000000000000000000000000011100455553E4
30000000822222290000000000000000014555304
30C00000114314310000000000000000001111104
79000890004301100000000082222229000000004
530001100043C0000000000865555557900000004
53000000001829000000008655555555722222226
57900000000143000C00004555555555555555555
55300000000C43000000004555555555555555555
55722900000047222222226555555555555555555
55555722222265555555555555555555555555555