311111111111455
3C0000000000455
3000P0000000114
7222A000C000004
555530000000004
555530000000004
311110000C00004
3C00000000000E4
722222222222226