555555555555555
531111111111145
5300PEC00C00045
530000008900045
572222226722265
555555555555555