555555555555555555555555555555555555555555555
531111111111111111111111111111111111111111145
53000EC00C00000000000000000000000000000000045
530000008900000000000000000000000000000000045
530000000000000000000000000000000000000000045
530000000000000000000000000000000000000000045
530000000000000000000000000000000000000000045
530000000000000000000000000000000000000000045
53000000000000000000000000000000000000P000045
530000000000000000000000000000000000000000045
530000000000000000000000000000000000000000045
530000000000000000000000000000000000000000045
530000000000000000000000000000000000000000045
530000000000000000000000000000000000000000045
572222226722222222222222222222222222222222265
555555555555555555555555555555555555555555555