1111111111111
100PEC00C0001
1000000000001
1111111111111